1111111
1000001
1010001
1010001
1011001
1000001
1111111
1c00001
1111111
