111111111111
1C0000000001
100111111001
1001E0001001
111111111111