1111111111111
1E01000000001
10000101P0101
1111111111111