1111111111111
1P01000000001
10000111C0101
100C000C00001
1000010000CE1
1111111111111