111111
100001
100001
10C001
111111