11111111111111111111111111111111111111111111111111111111111111111111111111111
100000000000000000000000000K0000000000000PCE111111111111111111111111111111111
11111111111111111111111111111111111111111111111111111111111111111111111111111
11111111111111111111111111111111111111111111111111111111111111111111111111111