1111111111111111111111111111111111
1000000000000000000000000000000001
10000101001000001010010000P0010101
1000010010101010001001000000010101
10000000000000000C000000C000000001
10000E00000000C00C0000000000000001
1000000000000000000000000000000001
1111111111111111111111111111111111