1111111111111111111111111111111111
1000000000C00000000C00000000000001
1P0E010100100000101001000000010101
1000010010101010001001000000010101
1000000000C00000000000000000000001
10000000000000000000C0000000000001
10000000000000C0000000000000000001
1111111111111111111111111111111111