1111111111111111111111111111111111
1000000000000000000000000000000011
10000101001000001010010000P0010111
1000010010101010001001000000010111
100000000000000000000000C000000011
10000E0000000000000000000000000011
1111111111111111111111111111111111
1111111111111111111111111111111111